#######
#@    #
##### #
#e    #
#######