###########
#        e#
#         #
#         #
#         #
#@        #
###########