###########
#         #
#      e  #
#         #
# @       #
#         #
###########