###########
#@        #
#         #
#####     #
#         #
#e        #
###########