##########
#@   #   #
#### # # #
#      # #
######## #
#e       #
##########