###########
#         #
# @       #
#         #
#####     #
#         #
# e       #
#         #
###########